{
  "fileType":"tilemap",
  "width": 12,
  "height": 12,
  "tiles": [
    "000000000000",
    "000000000000",
    "000000000000",
    "000000000000",
    "000000000000",
    "000000000000",
    "000000000000",
    "000000000000",
    "012222222230",
    "046666666650",
    "046666666650",
    "046666666650"
  ]
}